30 36
####################################
#                  ###         #####
# #### ###########     #######     #
# #### #           ###     # # ### #
#        #########     # # ### # # #
# ##### ###      ### ### # # # # # #
# #   #   #        # ### # # # # # #
# #   # # #        # ### #   # # # #
# ##### # ########## ### ##### ### #
#                                  #
# ####### ######## ####### ####### #
# ####### ######## ####### ##   ## #
#    ##   ##       ##BBB## ##      #
#    ##   ######## ##BBB## ##      #
#    ##   ##       ##BBB## ##  ### #
# #####   ######## ##BBB## ##   ## #
# #####   ######## ##BBB## ####### #
#                                  #
# ###### ### ########## ###### ### #
# #    # ### #####   #         # # #
# ######         ##### ### ### # # #
#        #######       # # # # # # #
# ###### #     ##### ### # # # ### #
# #    # ########### ##### ###     #
# ###### #               .P..# ### #
#          ######### #######.# # # #
# ####### ########## #     #P  # # #
# #######            #######.# ### #
#         ##########         #     #
####################################
